OOOOOOOOOO
OX  O    O
O O O OO O
O OOO.OOOO
O OOO   OO
O  .  O OO
OOOOO    O
O   . OO.O
O OOOOOO O
O      O O
OOOOOOUOOO
